   
   
   
   
        
        F 231,121,100
        
EA ./src/Cub3D/texture/wall_ea.xpm              

C 7,228,137
SO ./src/Cub3D/texture/wall_so.xpm

                WE ./src/Cub3D/texture/wall_we.xpm
NO ./src/Cub3D/texture/wall_no.xpm



        111111111111111111111111111111111
        1E0000000001100000000000000000001
        11110000011100000000000000000001
        100000000000001111111111111111111
1111111100110000011100000000000000000001
1000000000110000011101111111111111111111
11110111111111011100000010000000000000001111111111111111111
11110111111111011101010010000000000000000000000111100000001  
10000000110101011100000000000000000000000000000000000011111
1000000000000000110000001000111111111111111111111111111
10000000000000001101010010001
11000001110101001111011110001
11110111 1110101 101111000001
11111111 1111111 111111111111
